10
10
GBGGGGGGGG
G G      G
G G  G G G
G B  G G G
G     GGGG
Gbbb     G
G  v     G
G vb     G
G    G   G
GGGGGGGGGG