10
10
GGGGGGGGGG
G G      G
G G  G G G
G G  G G G
G    G   G
GGGGGG   G
G  G     G
G GG     G
G    G   G
GGGGGGGGGG