10
10
GGGGGGGGGG
G G      G
G G  G G G
G G  G G G
G     GGGG
GGGG     G
G  G     G
G GG     G
G    G   G
GGGGGGGGGG