10
10
GBGGGGGGGG
G G      G
G G  G G G
G B  G G G
G     GGGG
GGGG     G
G  G     G
G GG     G
G    G   G
GGGGGGGGGG